################
#S.............#
#..####.####...#
#..#..K.#......#
#..#....#......#
#..#....#..T...#
#..######......#
#..........B...#
#...G......O...#
#..########....E
################
