################
#S............O#
#..####T####..T#
#..#..K.#....T.#
#..#....#...T..#
#..#....#..T...#
#..######......#
#..........B...#
#...G......O...#
#..########....E
################